XXXXYYE1YY
XXXXYYYYII
XXXXXXXXYY
XXXXXXXXXX
        U1
        U1
XXXXXXXXXX
YYYYXXXXE2
XXYYYYYYYY
XXYYYYYYXX
        U2
        U2
YYYYYYXXE3
YYYYYYYYXX
YYYYYYYYXX
XXXXXXXXXX
U3        
U3        
XXXXXXGGXX
YYYYYYYYXX
YYYYYYXXXX
XXXXYYYYXX