IIXXYYYYXX
YYYYYYXXXX
YYXXE1XXXX
XXXXXXXXXX
      U1  
      U1  
YYXXXXXXXX
YYYYYYYYXX
XXXXXXXXXX
E2XXXXXXXX
    U2    
    U2    
YYYYE3YYXX
XXXXXXYYXX
XXXXYYYYXX
XXXXYYXXXX
      U3  
      U3  
XXXXXXXXXX
XXYYYYYYXX
XXYYXXXXXX
XXYYXXXXGG