XXXXE1XX
YYXXXXII
XXXXXXXX
    U1  
    U1  
E2XXXXXX
XXXXXXXX
XXYYXXXX
U2      
U2      
XXYYYYYY
XXXXXXXX
XXXXGGXX