XXYYYYYYXX
YYYYE1YYXX
YYXXXXIIXX
XXXXXXXXXX
  U1      
  U1      
YYXXE2XXXX
YYYYYYYYXX
XXXXYYXXXX
XXXXXXXXXX
        U2
        U2
XXXXXXXXE3
YYYYYYXXXX
YYYYYYYYXX
XXXXXXYYXX
U3        
U3        
XXYYYYYYXX
XXXXXXYYYY
XXXXXXXXYY
GGXXXXXXYY