XXYYYYYYXX
XXXXXXYYYY
XXXXGGYYYY
XXYYYYYYYY
XXYYXXXXXX
U1        
U1        
XXXXXXYYYY
XXYYYYYYYY
XXYYYYYYYY
XXE1XXXXYY
IIXXXXXXXX