XXXXXXXX
XXXXIIXX
YYXXXXE1
      U1
      U1
XXXXXXXX
YYE2YYXX
XXXXYYYY
U2      
U2      
XXXXXXXX
XXYYYYYY
GGYYXXXX