XXE1XXYY
XXXXXXXX
XXXXXXII
U1      
U1      
XXXXXXXX
E2XXXXXX
XXXXXXXX
U2      
U2      
GGXXXXXX
XXYYYYXX
XXXXYYXX