XXIIYYYY
XXXXXXXX
XXXXE1XX
U1      
U1      
XXE2XXXX
XXXXXXXX
XXYYXXXX
    U2  
    U2  
YYXXXXXX
YYYYYYXX
XXXXYYGG