XXXXYYYYYYXX
XXXXYYXXXXXX
XXE1YYXXXXXX
XXYYXXXXXXXX
IIYYXXXXXXXX
YYYYXXXXXXXX
        U1  
        U1  
XXXXXXXXXXXX
XXXXXXXXXXXX
YYYYXXXXXXXX
XXYYYYYYYYYY
XXXXXXYYYYYY
XXXXXXE2YYXX
          U2
          U2
GGYYYYYYYYXX
YYYYXXXXXXXX
YYYYYYXXXXXX
YYYYXXXXXXXX
XXYYYYXXXXXX
XXXXYYYYYYYY