XXXXXXXXIIXX
XXXXYYYYYYGG
XXXXYYYYYYXX
YYYYYYYYXXXX
YYYYXXXXXXXX