XXXXXXXXXXXX
YYXXXXXXXXXX
YYXXGGXXXXXX
YYXXXXXXXXXX
IIXXXXXXXXXX