XXXXXXXXXX
XXXXYYYYYY
XXIIXXXXYY
XXXXXXE1YY
    U1    
    U1    
XXXXXXXXXX
XXYYYYYYXX
XXXXXXYYYY
XXE2XXXXXX
U2        
U2        
XXYYXXXXXX
XXYYYYYYYY
XXYYYYYYYY
XXXXYYYYE3
  U3      
  U3      
XXXXGGXXXX
XXXXXXXXXX
XXXXXXYYYY
XXXXXXXXYY