XXXXXXE1
YYYYXXXX
XXIIXXXX
  U1    
  U1    
XXXXXXXX
XXYYYYXX
XXYYE2YY
U2      
U2      
GGYYXXXX
YYYYXXXX
XXXXXXXX