XXXXXXXXXX
XXXXXXXXXX
IIXXXXXXXX
XXXXXXYYXX
XXXXE1YYYY
    U1    
    U1    
XXXXXXXXXX
XXXXYYYYGG
XXXXYYYYXX
XXXXXXYYXX
XXXXXXXXXX