YYXXXXXXE1XX
YYYYXXXXXXXX
XXYYXXXXXXII
YYYYYYYYYYXX
YYXXXXXXXXXX
        U1  
        U1  
YYYYYYXXXXXX
XXYYYYYYXXXX
XXYYYYYYYYYY
XXYYYYYYXXXX
XXXXXXYYE2XX
        U2  
        U2  
XXYYYYXXXXXX
XXYYYYYYYYYY
XXXXXXXXXXYY
XXXXXXXXXXYY
XXXXXXXXXXGG