XXXXXXXX
YYYYE1XX
XXXXYYII
      U1
      U1
XXXXXXXX
XXXXE2XX
XXXXXXYY
    U2  
    U2  
XXXXGGYY
XXYYYYXX
XXYYXXXX