XXYYGGYYYYYY
XXIIYYYYXXXX
YYYYYYYYXXXX
YYYYYYYYYYXX
XXXXXXXXYYYY