YYYYYYXXXX
XXXXE1XXXX
XXYYYYYYXX
IIYYXXXXXX
U1        
U1        
XXYYYYXXXX
XXYYYYYYYY
XXXXYYE2XX
XXXXXXXXXX
U2        
U2        
XXXXXXXXXX
YYYYYYYYXX
YYYYYYYYXX
XXXXXXYYE3
        U3
        U3
XXGGXXXXXX
XXXXXXXXXX
XXYYYYYYXX
XXYYYYYYYY