YYYYYYGGXX
XXXXXXYYYY
XXXXXXXXYY
XXXXXXXXXX
        U1
        U1
XXXXXXXXXX
XXYYYYYYXX
XXIIYYXXXX
E1XXYYXXXX