YYYYIIYYYYXX
YYYYYYXXXXXX
XXXXYYYYE1XX
XXYYYYYYXXXX
XXYYYYYYYYYY
XXYYXXXXXXXX
      U1    
      U1    
XXXXXXXXXXXX
XXXXXXXXE2XX
XXYYYYYYYYYY
XXYYYYYYXXXX
XXYYYYYYXXXX
XXYYYYXXXXXX
        U2  
        U2  
XXXXXXXXXXXX
YYYYYYYYYYXX
XXXXYYXXXXXX
YYYYYYXXXXXX
YYYYYYYYYYXX
YYGGYYXXXXXX