XXXXXXXXXX
XXXXE1XXXX
YYYYYYXXII
YYXXXXXXXX
      U1  
      U1  
YYYYYYXXXX
XXXXYYXXXX
XXXXXXE2XX
XXXXXXXXXX
    U2    
    U2    
XXXXXXXXXX
XXXXE3XXXX
XXXXXXXXYY
XXXXXXXXXX
        U3
        U3
XXXXXXXXXX
XXYYYYYYYY
XXYYYYYYXX
XXGGXXYYYY