XXXXXXXXXXXX
XXXXXXXXXXXX
XXXXYYYYE1YY
XXXXYYYYXXII
XXXXYYYYYYXX
          U1
          U1
XXXXXXXXE2XX
XXYYYYYYYYXX
XXYYYYYYYYXX
XXXXXXXXYYXX
XXXXXXXXXXXX
          U2
          U2
YYYYYYXXGGXX
XXXXYYYYXXXX
XXXXYYYYXXXX
YYYYYYXXXXXX
YYYYXXXXXXXX