IIXXXXXX
XXXXYYYY
XXE1YYYY
U1      
U1      
XXXXXXXX
XXXXE2XX
XXXXXXXX
  U2    
  U2    
XXXXXXXX
YYYYGGXX
XXYYXXXX