XXYYIIYYXX
XXXXXXYYYY
E1XXXXXXXX
XXXXXXXXXX
  U1      
  U1      
XXXXXXXXYY
XXXXXXXXYY
XXXXXXXXYY
XXXXGGXXXX