XXXXXXXXXXXX
YYYYYYYYXXXX
XXYYXXXXXXXX
XXYYYYYYYYE1
XXXXXXXXIIXX
  U1        
  U1        
XXXXXXXXXXXX
XXYYYYYYYYYY
XXXXYYE2XXXX
XXXXXXYYXXXX
XXXXXXYYYYXX
          U2
          U2
YYXXXXXXXXXX
YYYYYYYYXXXX
XXYYGGXXXXXX
YYYYYYYYXXXX
YYXXXXXXXXXX