XXXXYYYYXX
XXXXYYGGYY
XXXXXXXXYY
XXXXXXXXXX
        U1
        U1
XXYYYYYYXX
XXE1XXYYXX
XXXXYYYYXX
IIXXYYXXXX