YYYYYYYYGGXX
XXXXXXYYYYII
XXYYYYYYYYXX
XXYYYYYYYYYY
XXXXXXXXXXYY