XXIIXXYY
E1XXXXXX
XXXXXXXX
      U1
      U1
YYYYXXE2
YYXXXXXX
XXXXXXXX
    U2  
    U2  
XXXXXXXX
YYXXXXXX
XXXXGGXX