XXYYYYYYYYYY
XXXXXXXXYYYY
XXXXIIYYYYXX
XXXXYYGGYYXX
XXXXXXXXXXXX