XXXXYYXX
XXIIXXXX
E1XXXXXX
  U1    
  U1    
XXXXYYXX
XXXXYYYY
XXE2XXXX
    U2  
    U2  
XXXXXXGG
XXXXXXXX
YYYYXXXX