XXXXXXXXXX
XXXXYYYYE1
XXXXXXYYXX
XXXXIIYYXX
  U1      
  U1      
YYXXXXXXXX
YYYYYYYYXX
GGYYYYYYXX
XXYYXXXXXX