XXXXYYYYYY
XXXXYYXXXX
XXXXYYGGXX
XXXXXXXXXX
      U1  
      U1  
XXXXXXE1XX
YYYYYYXXII
XXYYXXXXXX
XXYYYYYYYY