XXYYYYXXXX
XXYYGGYYYY
XXXXYYYYYY
XXXXXXXXYY
U1        
U1        
XXYYYYYYYY
XXYYYYIIXX
XXXXXXYYXX
XXXXE1XXXX