XXXXYYXXXXXX
XXXXYYYYYYXX
XXXXXXYYXXXX
XXXXXXE1XXXX
XXXXXXYYIIXX
U1          
U1          
XXXXXXXXXXXX
XXXXXXXXXXXX
XXXXYYYYXXXX
XXYYYYXXXXXX
E2YYYYXXXXXX
          U2
          U2
XXXXYYYYYYXX
XXYYYYGGYYYY
XXYYXXXXXXXX
XXYYYYXXXXXX
XXYYXXXXXXXX