XXXXXXXXXXXX
XXYYYYXXXXXX
XXYYYYGGXXXX
XXYYYYYYXXII
XXYYXXXXXXXX