YYYYYYXXE1
YYYYYYXXXX
XXYYYYIIXX
XXXXXXYYXX
  U1      
  U1      
YYXXXXXXXX
YYYYXXXXXX
GGYYYYYYXX
XXXXXXYYXX