XXYYYYXXXXXX
XXYYYYYYYYYY
XXYYXXXXE1XX
XXYYYYYYXXXX
XXXXXXYYXXII
        U1  
        U1  
XXXXXXXXXXXX
XXXXYYYYYYYY
XXYYYYXXXXXX
XXYYXXE2XXXX
XXXXXXXXXXXX
      U2    
      U2    
XXXXXXXXYYYY
XXXXYYYYYYYY
XXXXYYYYYYYY
YYYYYYYYGGXX
YYYYYYXXXXXX