XXYYYYYYYYYY
XXXXYYYYYYXX
XXXXXXXXYYYY
XXXXIIXXYYXX
XXGGXXXXXXXX