XXYYYYYYYYXX
XXIIYYYYXXXX
YYYYYYE1YYXX
YYYYYYYYYYXX
XXXXXXXXYYXX
  U1        
  U1        
XXXXYYYYYYYY
XXYYYYYYYYYY
YYYYYYYYYYXX
YYYYYYE2XXXX
XXYYXXXXXXXX
U2          
U2          
XXXXYYYYYYXX
YYYYYYYYYYXX
YYYYYYYYYYXX
XXXXXXYYYYYY
GGXXXXXXXXYY