YYYYYYXXXXXX
YYXXE1XXXXXX
YYYYYYYYXXXX
XXIIXXYYYYYY
XXXXXXXXXXXX
U1          
U1          
XXXXXXXXXXXX
XXYYYYYYYYYY
XXXXYYXXXXXX
XXYYYYXXXXXX
E2YYXXXXXXXX
U2          
U2          
XXXXXXXXYYXX
XXYYYYYYYYYY
XXYYXXXXXXXX
XXYYGGXXXXXX
XXYYYYYYYYXX