XXXXXXXXXXXX
E1YYYYYYXXXX
XXXXXXYYXXXX
XXIIYYYYXXXX
XXYYYYXXXXXX
U1          
U1          
XXXXXXXXXXXX
XXE2XXXXXXXX
YYYYYYYYXXXX
YYYYXXXXXXXX
XXXXXXXXXXXX
          U2
          U2
XXXXXXXXXXXX
XXYYYYYYXXXX
YYYYXXXXXXXX
YYYYYYYYYYXX
YYYYXXGGXXXX