XXYYYYYY
E1XXXXYY
XXIIXXXX
U1      
U1      
XXYYYYYY
XXYYXXXX
E2XXXXXX
      U2
      U2
YYGGXXXX
XXYYYYYY
XXXXXXYY