XXXXXXXXXX
YYXXXXXXXX
YYYYYYYYXX
XXYYYYYYGG
        U1
        U1
YYYYYYYYXX
E1XXXXYYYY
XXYYYYYYXX
XXYYIIXXXX