YYYYYYXXII
YYYYYYE1XX
XXXXYYXXXX
XXXXXXXXXX
U1        
U1        
XXXXYYYYE2
XXYYYYYYYY
XXYYXXXXXX
XXXXXXXXXX
U2        
U2        
XXXXXXYYXX
XXXXXXYYXX
E3XXXXXXXX
XXXXXXXXXX
    U3    
    U3    
YYYYXXXXXX
XXYYYYXXXX
XXXXYYXXXX
GGXXXXXXXX