YYYYXXXXIIXX
XXYYGGYYYYYY
YYYYYYYYYYXX
YYYYYYYYXXXX
XXXXXXYYXXXX