XXYYIIYYYYXX
XXYYYYGGYYXX
XXYYYYYYXXXX
XXXXXXYYXXXX
XXXXXXXXXXXX