XXXXXXXXXX
XXXXXXYYXX
XXXXXXYYXX
XXGGXXYYXX
        U1
        U1
XXXXXXE1XX
YYYYXXXXII
YYYYYYYYXX
XXYYYYYYYY