XXYYXXXXXX
XXYYXXE1XX
XXYYYYYYYY
XXXXXXYYII
    U1    
    U1    
XXXXXXXXXX
YYYYYYXXXX
XXXXE2XXXX
XXXXYYXXXX
      U2  
      U2  
YYYYE3XXXX
YYYYYYYYXX
YYYYYYYYXX
XXXXXXXXXX
U3        
U3        
XXYYYYYYXX
XXXXXXYYXX
XXGGXXYYYY
XXXXXXXXXX