IIYYYYYYXX
YYXXXXXXXX
YYYYE1XXXX
XXXXXXXXXX
        U1
        U1
YYYYYYYYXX
YYYYYYXXXX
YYYYXXE2XX
XXXXXXXXXX
    U2    
    U2    
XXXXXXYYXX
XXYYYYYYYY
XXYYE3YYYY
XXXXXXXXXX
      U3  
      U3  
XXXXXXXXXX
XXXXYYYYGG
YYYYYYYYXX
YYXXXXXXXX