XXXXXXXXXX
XXXXXXE1XX
XXXXYYXXXX
XXIIXXXXXX
        U1
        U1
XXXXXXXXXX
XXXXXXXXE2
XXYYYYYYYY
XXXXXXXXXX
        U2
        U2
XXYYE3YYXX
XXXXXXYYXX
XXXXXXYYXX
XXXXXXXXXX
      U3  
      U3  
XXXXXXXXGG
XXXXXXYYYY
XXXXYYYYXX
XXXXYYXXXX