YYGGYYXXXX
YYXXXXXXXX
YYYYYYXXXX
XXXXXXXXXX
  U1      
  U1      
XXXXXXXXXX
XXXXXXYYYY
XXE1YYIIYY
XXXXYYYYYY