YYYYYYYYXX
XXYYXXXXII
YYYYYYYYXX
YYXXE1XXXX
        U1
        U1
E2XXXXXXXX
XXXXYYXXXX
XXYYYYXXXX
XXYYYYYYXX
        U2
        U2
XXYYE3YYXX
XXYYYYXXXX
XXYYYYYYXX
XXXXXXYYXX
  U3      
  U3      
XXXXXXXXXX
XXXXYYYYYY
XXGGYYYYXX
XXXXYYXXXX