XXXXYYYYE1XX
XXXXYYXXXXII
XXYYYYXXXXXX
XXYYYYYYYYYY
XXYYXXXXXXXX
        U1  
        U1  
YYYYYYYYXXXX
XXE2YYYYYYYY
YYYYYYXXXXXX
YYYYYYYYYYXX
XXXXXXXXYYXX
      U2    
      U2    
XXXXXXXXXXXX
XXXXYYYYYYYY
YYYYYYXXXXXX
YYYYXXXXGGXX
XXYYYYYYYYXX