XXYYYYXXXX
XXYYXXXXXX
XXYYIIYYXX
E1XXXXYYXX
  U1      
  U1      
XXXXXXXXXX
XXYYYYYYYY
YYYYYYXXXX
YYYYYYXXE2
        U2
        U2
XXE3XXXXXX
XXYYYYYYYY
XXYYYYYYXX
XXXXXXYYXX
        U3
        U3
XXXXXXXXXX
XXYYYYYYYY
XXGGXXYYYY
XXXXXXYYYY