XXIIYYYYXX
XXXXE1YYXX
XXXXXXYYXX
XXXXXXXXXX
      U1  
      U1  
YYYYYYXXE2
YYXXXXXXXX
XXXXXXXXXX
XXXXXXXXXX
        U2
        U2
XXXXXXXXXX
XXXXXXXXXX
XXYYYYYYXX
E3YYYYYYXX
U3        
U3        
XXYYYYYYYY
XXXXXXYYYY
YYYYYYYYXX
YYXXXXXXGG