XXXXYYXXXX
XXXXYYYYXX
XXXXXXXXXX
XXXXXXXXGG
  U1      
  U1      
XXXXIIXXXX
XXYYYYE1YY
XXXXXXXXYY
XXXXXXXXXX