XXXXXXXXXX
XXYYYYYYXX
XXYYXXXXXX
XXXXXXXXXX
XXXXXXGGXX
U1        
U1        
XXXXYYYYYY
XXXXXXXXYY
XXYYE1YYYY
XXYYYYYYII
XXXXXXYYXX