YYYYXXXXXXXX
YYYYYYYYXXXX
XXYYYYYYYYYY
XXIIYYYYYYYY
GGXXXXXXXXYY