YYYYYYYYYYXX
YYYYYYXXXXXX
YYXXXXIIXXXX
YYYYYYYYXXXX
XXXXXXYYE1XX
    U1      
    U1      
XXXXXXXXXXXX
XXYYYYXXXXXX
XXXXYYYYXXXX
XXXXYYXXXXXX
XXE2XXXXXXXX
  U2        
  U2        
XXXXXXXXXXXX
XXYYYYGGYYXX
XXYYYYYYYYYY
YYYYYYXXXXXX
YYYYYYYYXXXX