XXXXXXXXXXXX
XXXXXXXXXXXX
YYYYYYYYYYXX
XXYYYYXXE1XX
XXYYXXXXXXII
        U1  
        U1  
XXXXXXXXXXXX
YYXXXXXXXXXX
YYYYYYXXXXXX
XXE2YYYYYYYY
XXXXXXXXXXYY
U2          
U2          
XXXXXXXXGGXX
YYYYYYYYXXXX
XXXXYYYYYYYY
XXYYYYYYXXXX
XXYYYYYYYYYY