XXXXXXXXYYII
XXXXXXYYGGYY
YYYYYYYYYYXX
YYYYYYXXXXXX
XXXXXXXXXXXX