XXXXXXGGXX
YYYYYYXXXX
YYXXXXXXXX
YYYYYYXXXX
      U1  
      U1  
XXXXXXXXXX
YYYYYYIIXX
YYXXXXXXXX
YYE1XXXXXX