YYYYYYYYYYXX
YYYYXXXXIIXX
XXYYYYYYYYE1
XXYYYYYYYYXX
XXXXXXXXXXXX
    U1      
    U1      
YYYYE2XXXXXX
XXYYYYYYYYXX
XXXXYYXXXXXX
XXYYYYXXXXXX
XXYYXXXXXXXX
      U2    
      U2    
XXXXXXXXXXXX
XXXXXXXXXXXX
XXXXYYYYXXGG
XXXXYYYYYYYY
XXXXXXXXYYXX