XXXXYYYYYYXX
XXIIXXXXYYXX
YYYYGGYYYYXX
YYYYYYXXXXXX
XXXXYYYYYYYY