XXXXXXXXXX
XXXXE1YYXX
YYYYYYYYXX
YYYYXXIIXX
        U1
        U1
YYXXXXXXXX
YYYYE2XXXX
XXYYYYYYYY
XXXXXXXXYY
U2        
U2        
XXXXXXXXXX
XXE3YYYYXX
XXYYYYYYYY
XXXXYYXXXX
      U3  
      U3  
XXXXXXXXXX
XXXXXXXXXX
XXGGYYXXXX
XXYYYYYYYY