YYXXIIXX
YYYYXXE1
XXXXXXXX
  U1    
  U1    
XXXXXXXX
XXXXXXYY
XXXXXXE2
    U2  
    U2  
XXYYXXXX
GGXXXXXX
XXXXXXXX