XXXXXXYYYY
XXXXXXIIYY
XXE1XXXXYY
XXXXXXXXXX
  U1      
  U1      
XXXXXXXXXX
XXYYXXXXXX
XXYYGGYYXX
XXXXYYYYYY