YYYYXXXXXX
XXYYXXE1XX
XXYYYYXXII
XXXXYYYYYY
  U1      
  U1      
XXXXXXXXXX
XXXXYYYYXX
XXXXYYGGXX
XXXXYYYYYY