XXIIYYYYYYYY
XXXXXXGGYYXX
YYYYYYYYYYXX
YYYYYYXXXXXX
YYYYYYYYYYXX