XXXXXXXXXX
YYIIXXXXXX
XXYYXXXXXX
XXYYE1YYXX
        U1
        U1
XXXXXXXXXX
XXXXYYYYYY
XXXXGGXXYY
XXXXXXXXYY