YYYYYYYYXX
YYYYE1XXXX
XXXXYYYYXX
IIXXXXYYXX
U1        
U1        
XXXXXXXXXX
YYYYYYXXXX
YYYYXXE2XX
XXYYXXXXXX
    U2    
    U2    
XXXXXXYYYY
XXXXXXXXXX
XXXXE3XXXX
XXXXXXXXXX
      U3  
      U3  
YYYYYYXXXX
XXYYXXXXXX
XXYYXXXXGG
XXXXXXXXXX