YYYYYYYYXX
YYXXXXXXXX
YYYYYYIIXX
XXE1XXYYYY
U1        
U1        
XXYYYYYYXX
XXYYYYYYYY
XXXXE2XXYY
XXXXXXXXXX
U2        
U2        
XXYYXXXXXX
XXYYYYYYYY
XXXXXXYYE3
XXXXXXYYYY
U3        
U3        
XXYYGGYYXX
XXYYYYYYXX
XXYYYYYYYY
XXXXXXXXYY