XXYYYYYYYYXX
XXYYXXXXXXXX
XXYYYYYYYYE1
XXXXXXXXIIYY
XXXXXXXXYYXX
          U1
          U1
YYYYYYYYYYXX
XXYYYYYYYYXX
XXXXXXE2YYYY
XXYYYYYYYYYY
XXYYXXXXXXXX
        U2  
        U2  
YYYYYYXXXXXX
YYYYYYXXXXXX
XXXXYYYYYYYY
XXXXXXYYYYGG
XXXXXXYYYYYY