XXYYIIXX
XXXXXXE1
XXXXXXXX
      U1
      U1
XXXXXXE2
XXXXXXXX
XXXXXXXX
      U2
      U2
XXXXXXXX
XXXXGGXX
XXYYXXXX