XXYYYYYYE1YY
XXXXIIYYYYXX
XXYYYYYYXXXX
XXYYXXXXXXXX
XXXXXXXXXXXX
U1          
U1          
XXYYYYYYYYXX
XXYYYYYYYYYY
XXYYYYYYE2XX
XXYYYYYYYYYY
XXXXXXXXXXXX
U2          
U2          
XXXXXXXXXXXX
XXYYYYYYYYXX
XXYYGGXXXXXX
XXYYYYYYYYXX
XXXXXXXXXXXX