XXXXYYYYYYYY
YYYYYYYYXXXX
YYXXXXXXXXGG
YYYYXXIIXXXX
XXYYYYYYXXXX