XXE1YYYYYY
XXYYYYYYYY
XXXXYYIIYY
XXXXXXXXXX
U1        
U1        
XXYYYYYYXX
XXYYYYYYXX
XXXXE2YYXX
XXXXXXXXXX
        U2
        U2
XXYYYYYYXX
XXYYXXXXXX
XXYYE3YYYY
XXXXYYXXXX
  U3      
  U3      
XXXXYYYYYY
YYYYYYYYXX
GGXXXXXXXX
YYYYXXXXXX