XXXXGGXXXX
XXYYYYYYXX
XXYYYYYYYY
XXXXXXXXXX
    U1    
    U1    
XXXXXXXXXX
XXXXXXYYII
XXXXE1XXXX
XXXXXXXXXX