XXXXXXXXYY
XXXXXXXXXX
XXXXIIXXXX
E1XXXXXXXX
        U1
        U1
YYYYXXXXXX
XXYYXXXXXX
XXYYYYYYYY
XXXXE2XXXX
  U2      
  U2      
XXE3XXYYXX
XXXXYYYYXX
XXYYYYYYXX
XXYYYYXXXX
        U3
        U3
XXXXXXXXXX
XXXXYYYYYY
XXXXGGYYYY
XXXXYYYYXX