YYYYYYYYYYXX
YYXXXXXXXXXX
YYXXXXXXXXXX
YYYYXXXXGGXX
XXYYYYYYXXII