YYYYXXXXXXXX
YYYYYYIIXXXX
XXXXGGYYXXXX
XXXXXXYYYYXX
XXXXXXXXXXXX