XXXXYYIIXXXX
YYYYYYXXXXXX
YYGGXXXXXXXX
XXYYXXXXXXXX
XXYYYYYYYYYY