YYYYYYXXXX
XXXXYYXXXX
XXXXYYGGYY
XXXXXXYYYY
    U1    
    U1    
YYYYE1YYXX
IIXXXXYYXX
XXXXXXYYYY
XXXXXXXXXX