XXXXXXXX
YYXXIIXX
XXE1XXXX
      U1
      U1
XXXXE2XX
XXXXXXXX
YYXXXXXX
  U2    
  U2    
XXXXXXXX
XXGGXXXX
XXXXXXXX