XXXXIIXXXX
E1YYYYXXXX
XXXXXXXXXX
XXXXXXXXXX
        U1
        U1
YYYYXXXXXX
XXYYYYYYGG
XXXXYYYYYY
XXXXXXXXXX