XXE1XXXX
XXYYXXII
XXXXXXXX
U1      
U1      
XXXXXXXX
XXYYE2YY
XXYYXXXX
    U2  
    U2  
XXXXXXXX
XXGGXXXX
XXXXXXXX