YYYYYYYYXX
GGYYYYXXXX
XXXXYYYYYY
XXXXXXYYXX
  U1      
  U1      
XXXXXXXXXX
XXYYYYE1YY
XXIIYYYYYY
XXXXYYXXXX