XXYYYYYYXXXX
XXYYXXGGXXII
XXYYXXXXXXXX
XXYYYYYYYYYY
XXXXXXYYYYYY