XXXXXXXXXX
YYYYYYXXXX
E1XXYYYYXX
XXIIYYYYYY
  U1      
  U1      
XXXXXXXXXX
XXXXYYYYXX
XXE2YYXXXX
XXXXYYXXXX
  U2      
  U2      
XXXXE3XXXX
XXXXXXXXXX
XXYYXXXXXX
XXYYYYYYYY
U3        
U3        
XXGGXXYYXX
XXYYYYYYXX
XXYYYYXXXX
XXXXYYYYYY