XXXXYYYYYYYY
XXYYYYYYYYXX
XXYYXXXXXXXX
XXGGXXXXXXXX
XXYYYYIIYYXX