XXXXXXXXXXXX
YYYYXXXXXXXX
YYYYYYYYXXXX
XXYYXXXXE1XX
XXXXXXXXXXII
        U1  
        U1  
YYXXXXXXXXXX
YYYYYYYYXXXX
E2YYYYXXXXXX
XXXXYYYYYYXX
XXXXXXYYXXXX
        U2  
        U2  
XXXXXXXXXXXX
YYYYYYYYYYXX
XXYYYYYYYYXX
GGYYYYYYXXXX
XXXXXXYYYYXX