XXE1XXXXXX
YYYYYYYYXX
XXXXXXIIXX
XXXXXXYYXX
        U1
        U1
YYYYYYYYXX
XXXXXXXXXX
GGXXXXXXXX
XXXXXXXXXX