YYE1YYXX
YYXXIIXX
XXXXXXXX
  U1    
  U1    
XXXXXXXX
XXXXYYYY
E2XXXXXX
  U2    
  U2    
GGXXXXXX
XXXXYYXX
XXXXXXXX