XXXXXXE1
XXXXYYXX
XXXXIIXX
  U1    
  U1    
XXXXXXXX
YYE2XXXX
XXXXXXXX
      U2
      U2
YYXXXXXX
YYYYYYXX
XXGGYYXX