XXYYYYYYYYYY
XXYYYYYYXXXX
XXXXXXE1XXXX
YYYYYYYYYYXX
YYYYIIXXXXXX
      U1    
      U1    
XXYYXXXXXXXX
XXYYXXXXXXXX
XXYYYYYYYYYY
XXYYYYYYXXE2
XXXXXXYYYYXX
U2          
U2          
XXYYYYYYYYYY
XXYYYYYYYYXX
XXXXGGYYXXXX
YYYYYYYYYYXX
YYXXXXXXXXXX