XXXXXXIIXXXX
XXXXYYYYXXE1
XXYYYYXXXXXX
XXYYXXXXXXXX
XXYYYYYYYYXX
U1          
U1          
XXYYYYYYYYYY
XXYYYYYYE2XX
XXXXXXYYXXXX
YYYYYYYYXXXX
YYYYXXXXXXXX
      U2    
      U2    
XXXXXXXXGGXX
XXXXYYYYYYXX
XXXXXXXXYYYY
XXXXXXXXXXXX
XXXXXXXXXXXX