XXXXXXXXXX
XXXXE1XXXX
XXYYYYXXXX
XXIIXXXXXX
    U1    
    U1    
XXXXE2XXXX
XXXXYYYYXX
XXXXXXYYYY
XXXXXXXXXX
  U2      
  U2      
XXXXXXXXXX
XXYYYYYYXX
XXYYE3XXXX
XXXXYYYYXX
U3        
U3        
XXXXXXXXXX
XXXXXXYYXX
GGYYYYYYXX
XXYYYYYYYY