XXYYYYYYXXXX
IIYYYYYYYYXX
YYE1YYXXXXXX
XXXXYYYYYYXX
XXXXXXXXYYXX
XXXXXXXXYYYY
  U1        
  U1        
XXXXYYYYYYYY
XXXXXXYYYYXX
XXYYYYYYYYXX
XXYYYYYYYYYY
XXYYYYYYXXXX
XXYYYYXXE2XX
          U2
          U2
GGXXYYYYXXXX
XXYYYYYYYYXX
XXYYYYYYYYYY
XXXXYYYYYYYY
XXXXXXXXXXXX
XXXXXXXXXXXX