XXXXXXIIXX
XXYYYYYYE1
XXYYYYYYYY
XXYYXXXXXX
        U1
        U1
XXE2XXXXXX
XXXXXXXXXX
YYYYYYXXXX
XXXXXXXXXX
        U2
        U2
YYXXXXXXE3
YYYYYYYYXX
XXYYYYXXXX
XXXXXXXXXX
U3        
U3        
XXXXXXXXXX
YYYYGGXXXX
YYYYYYYYXX
YYYYXXXXXX