XXXXXXXXXX
E1XXXXYYYY
XXXXXXYYXX
XXIIXXXXXX
    U1    
    U1    
XXXXXXXXXX
XXGGYYYYYY
XXYYYYYYYY
XXXXXXXXYY