IIXXXXYYYYYY
XXE1YYYYXXXX
XXYYYYYYYYXX
XXYYXXXXXXXX
XXYYXXXXXXXX
U1          
U1          
XXYYYYYYYYXX
XXXXXXXXYYYY
XXXXXXXXXXYY
XXXXXXXXYYYY
E2XXXXXXYYXX
    U2      
    U2      
XXXXXXXXXXXX
YYXXXXXXXXXX
YYYYYYYYYYXX
YYYYYYXXXXXX
YYYYGGYYYYXX