XXXXXXII
XXE1YYYY
XXYYXXXX
      U1
      U1
XXXXXXXX
XXXXXXYY
E2XXXXXX
  U2    
  U2    
XXXXXXXX
YYYYYYXX
XXXXYYGG