XXYYYYYYXXXX
YYYYYYYYYYXX
YYIIXXXXXXXX
YYYYYYGGYYXX
XXXXXXXXYYXX