XXXXXXII
YYE1YYXX
XXXXXXXX
    U1  
    U1  
XXXXXXXX
XXXXXXE2
XXXXXXXX
  U2    
  U2    
XXXXXXYY
XXXXXXXX
XXXXXXGG