YYYYXXXXXXXX
XXYYYYYYYYYY
XXXXYYYYYYYY
XXIIYYYYYYXX
XXYYXXE1XXXX
        U1  
        U1  
XXYYYYXXXXXX
XXYYYYXXXXXX
XXXXYYYYYYYY
XXXXXXXXYYYY
E2XXXXXXYYXX
          U2
          U2
XXXXYYYYYYXX
XXYYYYXXXXXX
XXYYYYYYXXXX
XXXXGGYYXXXX
XXXXXXYYYYXX