YYYYYYYYXXXX
YYYYYYXXE1XX
XXXXYYYYYYXX
XXXXXXXXYYII
XXXXXXXXYYYY
U1          
U1          
XXXXXXXXXXXX
XXYYYYYYYYYY
XXYYYYYYE2XX
XXXXXXYYXXXX
XXXXXXYYXXXX
  U2        
  U2        
XXXXXXXXXXXX
YYYYYYYYXXXX
YYYYYYYYYYXX
XXXXXXXXYYXX
XXXXXXGGXXXX