YYYYYYYYXX
XXXXXXYYYY
XXYYE1YYII
XXYYXXXXXX
U1        
U1        
XXYYYYYYXX
XXYYXXXXE2
XXYYYYXXXX
XXXXYYXXXX
        U2
        U2
YYXXXXXXXX
YYXXE3XXXX
YYYYYYYYXX
XXXXXXYYXX
U3        
U3        
XXYYYYYYXX
YYYYYYXXXX
YYXXXXXXGG
YYXXXXXXXX