IIXXXXXXXX
XXE1YYXXXX
XXXXYYXXXX
XXXXXXXXXX
      U1  
      U1  
YYYYYYXXXX
XXYYXXXXXX
XXXXXXXXXX
E2XXXXXXXX
        U2
        U2
E3YYYYYYXX
YYYYYYYYXX
YYYYXXXXXX
XXXXXXXXXX
        U3
        U3
XXYYYYYYXX
YYYYYYXXXX
YYYYXXXXXX
XXXXXXGGXX