XXXXXXXXYYYY
XXXXYYYYYYXX
IIYYYYYYYYXX
YYYYXXXXXXXX
XXYYE1XXXXXX
U1          
U1          
XXXXYYYYXXE2
XXXXYYYYYYXX
XXXXXXYYYYXX
XXXXXXYYYYXX
XXXXXXXXXXXX
        U2  
        U2  
YYYYXXXXXXXX
YYYYYYYYYYXX
YYYYYYYYXXXX
XXXXXXYYXXXX
XXGGXXXXXXXX