YYYYYYYYXX
YYXXXXXXXX
YYYYYYYYXX
XXGGYYXXXX
U1        
U1        
XXXXXXXXXX
XXYYYYYYXX
XXIIXXXXXX
XXXXXXE1XX