XXYYYYXXXXXX
YYYYYYXXXXXX
YYIIXXE1XXXX
XXXXXXXXXXXX
XXXXXXXXXXXX
U1          
U1          
XXXXXXXXYYXX
XXYYYYYYYYYY
XXYYXXE2XXXX
XXYYYYYYXXXX
XXXXXXYYYYYY
U2          
U2          
XXXXXXGGXXXX
YYYYXXXXXXXX
XXYYYYYYYYXX
XXYYYYYYYYXX
XXYYYYYYXXXX