XXXXE1XX
YYYYXXXX
IIYYXXXX
U1      
U1      
E2YYYYXX
XXYYXXXX
XXXXXXXX
U2      
U2      
XXXXYYYY
XXXXXXYY
GGXXXXXX