XXYYYYYYYYYY
XXYYXXXXXXXX
XXYYE1XXXXXX
XXYYYYYYYYYY
IIXXXXXXXXXX
    U1      
    U1      
XXYYE2YYYYYY
XXYYXXXXXXXX
XXYYYYYYYYYY
XXXXXXXXXXYY
XXXXXXXXXXYY
  U2        
  U2        
XXXXXXXXXXXX
YYYYYYYYXXXX
GGYYYYXXXXXX
XXXXYYYYYYXX
XXXXXXXXYYXX