XXXXXXXXXXXX
XXYYYYYYYYYY
XXYYYYYYYYGG
XXXXXXYYYYYY
XXXXXXYYIIYY