XXYYXXXXXX
XXYYXXGGXX
XXYYYYXXXX
XXXXXXXXXX
  U1      
  U1      
XXXXXXXXYY
XXE1YYIIYY
XXXXYYYYYY
XXXXXXXXXX