YYXXXXIIXXXX
YYYYYYYYYYXX
YYGGYYYYYYXX
XXXXXXXXYYXX
XXXXXXXXXXXX