YYYYYYYYXX
XXXXXXYYXX
XXYYE1YYII
XXYYXXXXXX
        U1
        U1
XXXXYYXXXX
XXGGYYXXXX
XXXXXXXXXX
XXXXXXXXXX