YYYYYYYYYYXX
XXXXXXYYYYYY
XXXXYYYYYYXX
XXXXYYXXE1XX
XXXXXXIIXXXX
          U1
          U1
XXYYXXXXXXXX
XXYYXXXXXXXX
XXYYYYXXXXXX
XXXXYYE2YYYY
XXXXXXYYXXXX
          U2
          U2
YYYYYYXXXXXX
YYXXXXXXXXXX
YYXXXXXXXXGG
YYYYYYYYXXXX
XXXXXXYYXXXX