XXXXYYIIYYYY
XXXXYYXXXXXX
XXGGYYYYYYXX
YYYYYYYYYYXX
YYXXXXXXXXXX