IIXXXXXXXXXX
XXE1XXXXXXXX
XXYYXXXXXXXX
XXYYYYYYYYYY
XXYYYYYYYYYY
XXYYXXXXXXXX
U1          
U1          
XXXXXXYYYYYY
XXXXXXYYYYXX
XXXXXXYYYYYY
XXYYYYYYXXXX
XXYYXXXXXXXX
E2YYYYYYXXXX
        U2  
        U2  
XXXXXXXXXXXX
XXXXYYYYYYYY
XXXXYYYYYYYY
GGYYYYXXXXXX
YYYYYYYYYYXX
XXXXXXYYYYYY