XXYYYYYY
XXE1XXXX
IIXXXXXX
U1      
U1      
XXYYE2XX
XXXXXXXX
XXXXXXXX
      U2
      U2
GGXXXXXX
YYYYXXXX
XXYYYYXX