XXXXXXIIXX
XXYYYYYYYY
XXE1XXXXXX
XXYYYYYYYY
U1        
U1        
XXXXXXXXXX
XXYYYYYYYY
XXYYYYXXE2
XXXXYYYYYY
U2        
U2        
XXYYYYYYYY
YYYYXXXXXX
YYYYYYYYXX
E3XXYYYYXX
        U3
        U3
XXYYYYXXXX
YYYYYYXXGG
YYYYYYYYXX
XXXXXXXXXX