XXXXYYYYII
XXXXYYYYYY
XXYYYYE1YY
XXYYXXXXXX
      U1  
      U1  
XXYYXXE2XX
XXYYXXXXXX
XXYYYYYYYY
XXXXXXXXXX
U2        
U2        
XXYYYYYYYY
YYYYYYXXXX
YYYYYYXXXX
XXXXXXXXE3
    U3    
    U3    
XXXXXXXXXX
YYYYYYXXXX
XXXXYYXXXX
XXGGYYYYXX