XXXXIIXX
XXE1XXXX
XXXXYYXX
  U1    
  U1    
YYXXXXXX
YYXXXXXX
XXXXXXE2
      U2
      U2
XXXXXXXX
XXXXXXXX
YYGGYYXX