XXXXXXGGXX
YYYYYYXXXX
YYYYXXXXXX
XXXXXXXXXX
U1        
U1        
XXXXXXIIXX
XXXXXXXXE1
YYYYYYXXXX
XXXXYYYYXX