XXXXYYYYYYYY
XXXXYYXXXXXX
XXXXYYYYYYII
YYYYYYGGYYXX
YYXXXXXXXXXX