IIXXXXXX
XXXXE1XX
XXXXXXYY
U1      
U1      
XXYYYYYY
E2XXXXYY
XXXXXXXX
    U2  
    U2  
XXGGXXXX
YYXXXXXX
XXXXXXXX