YYYYYYXXXX
YYYYYYXXXX
XXYYYYXXXX
YYYYXXGGXX
YYXXXXXXXX
        U1
        U1
XXXXYYXXXX
XXXXYYYYYY
XXXXE1YYYY
XXXXXXYYII
XXXXXXXXXX