XXXXXXXX
E1XXXXXX
XXXXIIXX
      U1
      U1
YYYYYYXX
YYYYYYXX
XXXXXXE2
U2      
U2      
GGYYYYXX
XXYYYYYY
XXXXXXYY