XXYYYYXXGG
XXYYXXXXXX
XXYYYYYYXX
XXXXXXYYXX
U1        
U1        
IIXXYYYYXX
XXE1XXYYXX
XXYYYYYYXX
XXYYXXXXXX