XXYYYYYY
IIXXXXYY
XXXXE1XX
U1      
U1      
XXXXXXE2
XXYYXXXX
XXYYXXXX
U2      
U2      
GGXXXXYY
XXYYYYYY
XXYYXXXX