XXXXYYXX
XXE1XXXX
XXXXXXII
    U1  
    U1  
XXXXE2XX
XXXXXXXX
XXXXXXXX
      U2
      U2
XXXXGGXX
XXXXXXXX
XXXXYYYY