XXYYYYXXXXXX
XXYYYYYYYYXX
XXXXXXE1YYXX
YYYYIIYYYYXX
YYXXXXXXXXXX
          U1
          U1
XXYYXXXXXXXX
XXYYYYYYYYYY
XXXXYYYYYYXX
XXYYYYE2YYXX
XXYYXXXXXXXX
U2          
U2          
XXYYYYYYYYYY
XXYYYYYYYYYY
XXXXXXYYYYYY
XXXXXXYYYYGG
XXXXXXXXXXXX