XXE1XXXXYY
XXXXYYIIYY
XXXXYYYYYY
XXXXXXYYXX
U1        
U1        
XXXXXXYYYY
XXXXYYYYYY
E2XXYYXXXX
XXXXYYXXXX
        U2
        U2
E3XXYYYYXX
XXXXYYXXXX
XXYYYYYYXX
XXYYXXXXXX
        U3
        U3
YYYYXXXXXX
XXYYYYYYXX
XXXXXXYYYY
XXGGXXXXXX