YYYYXXXXII
XXYYYYYYYY
XXYYE1XXXX
XXXXYYXXXX
  U1      
  U1      
XXXXYYYYXX
XXXXYYYYGG
XXXXXXYYXX
XXXXXXXXXX