XXXXXXXXXXXX
XXIIXXXXXXXX
XXXXYYYYXXXX
XXYYYYGGXXXX
XXYYYYYYYYXX