YYYYXXXXXXXX
YYYYXXXXXXXX
YYYYYYYYXXXX
XXXXYYYYYYXX
XXYYYYE1XXXX
XXYYIIXXXXXX
    U1      
    U1      
XXXXXXXXXXXX
YYYYE2YYXXXX
YYYYYYYYXXXX
XXXXYYYYYYYY
XXYYYYXXXXXX
XXYYXXXXXXXX
    U2      
    U2      
XXXXXXXXXXXX
XXYYGGYYXXXX
XXXXYYXXXXXX
XXXXYYYYXXXX
XXXXYYYYXXXX
XXXXXXXXXXXX