XXXXXXE1
XXYYXXXX
XXIIXXXX
    U1  
    U1  
XXXXXXXX
XXXXXXXX
YYXXE2XX
  U2    
  U2    
XXXXXXYY
XXYYGGYY
XXYYYYXX