XXXXXXXXIIXX
YYYYYYYYXXXX
XXXXYYYYXXGG
YYYYYYXXXXXX
YYYYYYYYXXXX