XXYYYYYYYYYY
YYYYYYYYYYXX
YYYYYYYYXXE1
YYYYYYIIYYXX
XXXXXXXXYYXX
  U1        
  U1        
XXXXXXXXXXXX
YYYYXXXXXXXX
XXYYE2YYYYYY
XXXXXXXXYYXX
XXXXXXXXXXXX
    U2      
    U2      
YYGGXXXXXXXX
YYYYXXXXXXXX
YYYYYYYYYYXX
XXXXXXXXXXXX
XXXXXXXXXXXX