YYYYXXXXXX
YYYYYYXXXX
XXE1XXXXXX
IIXXXXXXXX
U1        
U1        
XXXXXXXXYY
XXXXXXXXXX
XXXXXXXXE2
XXXXXXXXXX
      U2  
      U2  
XXXXXXXXXX
XXE3XXXXXX
XXYYYYYYXX
XXYYYYYYXX
U3        
U3        
XXGGXXXXXX
XXXXXXXXXX
XXXXXXXXXX
YYYYYYYYXX