XXXXYYYYXX
YYYYE1YYXX
YYYYYYYYXX
XXIIXXXXXX
    U1    
    U1    
XXXXXXXXXX
YYYYYYXXXX
YYXXXXXXGG
XXXXXXXXXX