YYYYYYYYYYXX
YYYYYYYYYYXX
YYXXXXXXXXXX
YYXXXXXXXXXX
YYIIXXXXXXXX
XXXXXXE1XXXX
        U1  
        U1  
XXXXXXXXXXXX
XXYYYYYYYYXX
YYYYXXXXXXXX
YYYYYYYYYYXX
XXXXXXXXYYYY
E2XXXXXXXXYY
U2          
U2          
XXXXYYYYYYYY
XXXXYYGGXXXX
XXXXYYXXXXXX
XXXXYYXXXXXX
YYYYYYXXXXXX
YYXXXXXXXXXX