XXIIXXXX
XXXXE1XX
XXXXXXXX
U1      
U1      
XXE2XXXX
XXXXXXXX
YYYYYYXX
      U2
      U2
YYGGYYXX
YYXXXXXX
XXXXXXXX