XXXXXXXX
E1XXIIXX
XXYYXXXX
      U1
      U1
XXXXXXE2
XXXXXXXX
YYYYXXXX
      U2
      U2
XXXXXXXX
GGXXYYXX
XXXXYYYY