XXYYYYYYYYXX
XXXXXXXXYYXX
XXXXXXXXE1XX
XXXXXXIIYYXX
XXXXXXXXXXXX
          U1
          U1
XXE2XXXXXXXX
XXXXXXXXXXXX
XXYYYYXXXXXX
XXYYYYYYYYYY
XXYYXXXXXXXX
          U2
          U2
XXYYYYYYXXXX
XXXXYYYYXXXX
XXGGYYYYYYXX
XXYYYYYYYYYY
XXXXXXXXXXXX