YYYYE1XX
IIYYXXXX
XXXXXXXX
      U1
      U1
E2YYYYXX
XXYYXXXX
XXXXXXXX
    U2  
    U2  
XXXXGGXX
XXXXXXXX
XXYYYYYY