E1XXXXXX
XXIIXXXX
XXYYYYXX
U1      
U1      
XXXXXXXX
XXYYXXXX
XXXXXXE2
    U2  
    U2  
YYXXXXGG
XXXXXXXX
XXXXXXXX