YYYYYYYYXXXX
YYYYYYYYYYXX
XXXXXXYYXXII
XXXXXXYYGGYY
XXXXXXXXXXYY