XXXXXXXXXX
XXXXE1XXXX
IIYYXXXXXX
YYXXXXXXXX
      U1  
      U1  
E2XXXXXXXX
XXXXXXXXYY
XXXXXXXXYY
XXXXXXXXYY
      U2  
      U2  
XXXXXXXXXX
YYYYXXXXXX
XXYYYYYYXX
XXE3XXYYYY
U3        
U3        
XXYYYYYYYY
XXYYXXXXXX
XXYYYYYYYY
GGXXXXYYYY