YYYYYYXXXXGG
XXXXYYXXIIXX
XXXXYYYYYYXX
XXXXXXYYYYXX
XXXXXXXXXXXX