YYYYXXIIXXXX
YYYYYYYYYYXX
XXYYXXXXXXE1
XXYYYYYYYYXX
XXXXXXXXXXXX
        U1  
        U1  
XXXXXXXXXXXX
XXXXXXXXYYYY
XXXXXXXXYYE2
XXXXXXYYYYXX
XXXXXXYYXXXX
    U2      
    U2      
YYYYXXXXXXXX
XXYYXXXXXXXX
XXYYYYYYYYXX
GGXXXXXXXXXX
XXXXXXXXXXXX