XXYYYYYYYYXX
XXGGXXXXYYXX
XXYYYYYYYYXX
IIYYYYYYXXXX
XXXXXXXXXXXX