XXXXXXXXXX
XXYYYYE1YY
XXYYXXXXXX
XXYYYYXXII
        U1
        U1
XXYYYYYYXX
XXYYXXE2XX
XXYYYYYYXX
XXXXYYXXXX
        U2
        U2
XXXXYYYYXX
XXXXXXYYYY
XXE3YYYYXX
XXYYYYXXXX
        U3
        U3
XXGGXXXXXX
YYYYYYYYXX
YYYYYYYYXX
YYXXXXXXXX