XXXXXXXXXX
XXXXXXGGXX
XXYYYYXXXX
YYYYYYXXXX
YYXXXXXXXX
  U1      
  U1      
XXXXIIXXXX
XXXXXXXXXX
XXXXXXXXE1
XXXXXXXXXX
XXXXXXXXYY