XXE1XXXXXX
IIXXXXXXXX
YYYYYYYYXX
YYYYYYYYXX
        U1
        U1
YYYYYYXXXX
XXXXXXXXXX
XXXXXXXXXX
XXXXE2XXXX
      U2  
      U2  
XXXXXXXXE3
XXXXXXXXXX
YYYYYYYYXX
XXXXYYXXXX
U3        
U3        
XXYYXXXXXX
XXYYGGYYYY
XXYYXXXXXX
XXXXXXXXXX