YYYYYYYYXX
YYXXIIXXXX
YYYYXXE1XX
XXYYXXXXXX
XXXXXXXXXX
        U1
        U1
YYYYYYYYXX
YYYYXXXXXX
XXYYYYGGXX
XXXXYYYYXX
XXXXXXYYXX