XXXXXXXXXX
E1YYXXXXXX
XXYYYYYYYY
XXXXIIXXYY
      U1  
      U1  
YYYYXXXXXX
YYYYYYYYXX
YYYYYYXXGG
XXXXYYYYYY