YYYYYYYYXX
YYXXXXXXXX
YYYYXXGGXX
XXXXXXXXXX
        U1
        U1
XXXXXXE1XX
XXYYYYXXXX
YYYYYYXXII
YYXXXXXXXX