YYYYYYXXXXXX
YYYYXXXXXXII
XXYYYYXXXXXX
XXXXYYGGYYYY
XXXXXXXXXXYY