XXXXXXXXXXXX
XXXXXXXXXXXX
YYYYE1XXXXXX
XXXXYYXXXXXX
IIXXYYXXXXXX
      U1    
      U1    
XXXXYYE2XXXX
XXXXYYXXXXXX
XXXXYYYYYYXX
XXXXXXXXYYYY
XXXXXXXXXXYY
      U2    
      U2    
XXXXYYXXXXXX
XXXXYYYYYYXX
XXXXYYYYYYXX
XXXXYYYYGGYY
XXXXXXYYYYYY