                        IIXXXXXXXXXXXX
                                    XX
                                    XX
                                    XX
                                    XX
                                    XX
                                    XX
                                    XX
                                    XX
                                XXXXXX
                            XXXXXXXXXX
                            XXXXXXXXXX
                          XXXXXX      
                      XXXXXX          
                      XXXXXX          
                  XXXXXX              
                  XXXX                
                XXXXXX                
            XXXXXX                    
            XXXXXX                    
        XXXXXX                        
        XXXX                          
      XXXXXX                          
XXXXXXXX                              
XXXXXXXX                              
XXXXXXXX                              
  GGXXXX                              