                        XXXXXXII    
                        XXXXXX      
                        XXXXXX      
                          XX        
                          XX        
                          XX        
                          XX        
                          XX        
                          XX        
                          XX        
                          XX        
                          XXXXXX    
                          XXXXXX    
                          XXXXXXXXXX
                          XX  XXXXXX
                      XXXXXX        
                      XXXX          
                    XXXXXX          
                XXXXXX              
                XXXXXX              
            XXXXXX                  
            XXXX                    
          XXXXXX                    
      XXXXXX                        
      XXXXXX                        
  XXXXXX                            
XXGGXX                              
XXXXXX                              
XXXX                                