                              XXXX    
                            XXXXXX    
                            XXIIXX    
                                XX    
                                XX    
                                XX    
                                XX    
                                XX    
                                XX    
                                XX    
                                XX    
                          XXXXXXXX    
                          XXXXXXXXXXXX
                          XXXXXXXXXXXX
                          XXXXXX      
                          XXXXXX      
                      XXXXXX          
                      XXXX            
                    XXXXXX            
                XXXXXX                
                XXXXXX                
            XXXXXX                    
            XXXX                      
          XXXXXX                      
      XXXXXX                          
      XXXXXX                          
  XXGGXXXX                            
XXXXXXXXXX                            
XXXXXXXXXX                            
XXXX                                  