                            II      
                          XXXXXX    
                          XXXXXX    
                          XXXXXX    
                              XX    
                              XX    
                              XX    
                              XX    
                              XX    
                              XX    
                              XX    
                              XX    
                        XXXXXXXXXXXX
                        XXXXXXXXXXXX
                        XXXXXX      
                          XX        
                          XX        
                      XXXXXX        
                      XXXX          
                    XXXXXX          
                XXXXXX              
                XXXXXX              
            XXXXXX                  
            XXXX                    
          XXXXXX                    
      XXXXXX                        
XXXX  XXXXXX                        
XXXXXXXX                            
XXXXXX                              
XXGGXX                              
  XXXX                              