                          IIXXXX    
                          XXXXXX    
                          XXXXXX    
                          XXXXXX    
                              XX    
                              XX    
                              XX    
                              XX    
                              XX    
                              XX    
                              XX    
                              XX    
                        XXXXXXXXXXXX
                        XXXXXXXXXXXX
                          XXXXXX    
                          XXXX      
                      XXXXXX        
                      XXXX          
                    XXXXXX          
                XXXXXX              
                XXXXXX              
            XXXXXX                  
            XXXX                    
          XXXXXX                    
      XXXXXX                        
      XXXXXX                        
  XXXXXX                            
XXXXXX                              
XXXXXX                              
XXXXGG                              