                          IIXXXXXXXXXXXXXXXXXX    
                                            XX    
                                            XX    
                                            XX    
                                            XX    
                                            XX    
                                            XX    
                                            XX    
                                            XX    
                                        XXXXXX    
                                        XXXXXX    
                                        XXXXXXXXXX
                              XXXXXXXXXXXXXXXXXXXX
                          XXXXXX                  
                          XXXXXX                  
                      XXXXXX                      
                      XXXX                        
                    XXXXXX                        
                XXXXXX                            
                XXXXXX                            
            XXXXXX                                
            XXXX                                  
          XXXXXX                                  
      XXXXXX                                      
      XXXXXX                                      
  XXGGXXXX                                        
XXXXXXXXXX                                        
XXXXXXXXXX                                        
XXXX                                              