                                                                XXXXXXII                                                          
                                                                XX                                                                
                                                                XX                                                                
                                                                XX                                                                
                                                                XX                                                                
                                                                XX                                                                
                                                                XX                                                                
                                                                XX                                                                
                                                                XX                                                                
                                                                XXXXXXXX                                                          
                                                                      XXXX                                                        
                                                                      XXXX                                                        
                                                                        XXXXXX                                                    
                                                                          XXXX                                                    
                                                                          XXXXXX                                                  
                                                                              XXXXXX                                              
                                                                              XXXXXX                                              
                                                                                  XXXXXX                                          
                                                                                    XXXX                                          
                                                                                    XXXXXX                                        
                                                                                        XXXXXXXX                                  
                                                                                        XXXXXXXX                                  
                                                          XXXXXXXXXXXXXXXXXXXXXXXXXXXXXXXXXXXXXX                                  
                                                      XXXXXX                                                                      
                                                      XXXXXX                                                                      
                                                  XXXXXX                                                                          
                                                  XXXX                                                                            
                                                XXXXXX                                                                            
                                            XXXXXX                                                                                
                                            XXXXXX                                                                                
                                        XXXXXX                                                                                    
                                        XXXX                                                                                      
                                      XXXXXX                                                                                      
                                XXXXXXXX                                                                                          
                                XXXXXXXX                                                                                          
                                XXXXXXXXXXXXXXXXXXXXXXXXXXXXXXXXXXXXXXXXXXXXXXXXXXXXXXXXXXXXXXXXXXXXXXXX                          
                                                                                                    XXXX                          
                                                                                                    XXXXXX                        
                                                                                                        XXXXXX                    
                                                                                                        XXXXXX                    
                                                                                                            XXXXXX                
                                                                                                              XXXX                
                                                                                                              XXXXXX              
                                                                                                                  XXXXXX          
                                                                                                                  XXXXXX          
                                                                                                                      XXXXXX      
                                                                                                                        XXXX      
                                                                                                                        XXXXXXXXXX
                          XXXXXXXXXXXXXXXXXXXXXXXXXXXXXXXXXXXXXXXXXXXXXXXXXXXXXXXXXXXXXXXXXXXXXXXXXXXXXXXXXXXXXXXXXXXXXXXXXXXXXXXX
                        XXXXXX                                                                                              XXXX  
                    XXXXXX                                                                                                  XXXX  
                    XXXXXX                                                                                                        
                XXXXXX                                                                                                            
                XXXX                                                                                                              
              XXXXXX                                                                                                              
          XXXXXX                                                                                                                  
          XXXXXX                                                                                                                  
      XXXXXX                                                                                                                      
      XXXX                                                                                                                        
    XXXXXX                                                                                                                        
XXXXXX                                                                                                                            
XXXXXXGG                                                                                                                          
XXXXXX                                                                                                                            