                          XXXXXX
                          IIXXXX
                          XXXXXX
                              XX
                              XX
                              XX
                              XX
                              XX
                              XX
                              XX
                              XX
                        XXXXXXXX
                        XXXXXXXX
                          XXXXXX
                          XXXX  
                      XXXXXX    
                      XXXX      
                    XXXXXX      
                XXXXXX          
                XXXXXX          
            XXXXXX              
            XXXX                
          XXXXXX                
      XXXXXX                    
      XXXXXX                    
  XXXXXX                        
XXXXGG                          
XXXXXX                          
XXXXXX                          