                        IIXXXXXXXXXXXX
                                    XX
                                    XX
                                    XX
                                    XX
                                    XX
                                    XX
                                    XX
                                    XX
                                XXXXXX
                                XXXXXX
                          XXXXXXXXXXXX
                      XXXXXX          
                      XXXXXX          
                  XXXXXX              
                  XXXX                
                XXXXXX                
            XXXXXX                    
            XXXXXX                    
        XXXXXX                        
        XXXX                          
      XXXXXX                          
XXXXXXXX                              
XXXXXXXX                              
XXXXXX                                
XXXXGG                                
XXXXXX                                
XXXXXX                                