                          XXXX      
                          XXXXXX    
                          XXIIXX    
                          XXXXXX    
                              XX    
                              XX    
                              XX    
                              XX    
                              XX    
                              XX    
                              XX    
                              XX    
                          XXXXXX    
                          XXXXXX    
                          XXXXXXXXXX
                            XXXXXXXX
                          XXXX      
                          XXXX      
                      XXXXXX        
                      XXXX          
                    XXXXXX          
                XXXXXX              
                XXXXXX              
            XXXXXX                  
            XXXX                    
          XXXXXX                    
      XXXXXX                        
      XXXXXX                        
  XXGGXX                            
XXXXXXXX                            
XXXXXX                              
XXXX                                