                          XXXX  
                          IIXXXX
                          XXXXXX
                            XX  
                            XX  
                            XX  
                            XX  
                            XX  
                            XX  
                            XX  
                            XX  
                          XXXXXX
                          XXXXXX
                          XXXXXX
                          XXXXXX
                          XXXX  
                          XXXX  
                      XXXXXX    
                      XXXX      
                    XXXXXX      
                XXXXXX          
                XXXXXX          
            XXXXXX              
            XXXX                
          XXXXXX                
      XXXXXX                    
      XXXXXX                    
  XXXXXX                        
XXXXXXXX                        
XXXXGGXX                        
XXXX                            