                        XXXXII  
                        XXXXXX  
                        XXXXXX  
                          XXXXXX
                              XX
                              XX
                              XX
                              XX
                              XX
                              XX
                              XX
                              XX
                          XXXXXX
                          XXXXXX
                          XXXXXX
                      XXXXXX    
                      XXXXXX    
                  XXXXXX        
                  XXXX          
                XXXXXX          
            XXXXXX              
            XXXXXX              
        XXXXXX                  
        XXXX                    
      XXXXXX                    
XXXXXXXX                        
XXXXXXXX                        
XXXXXXXXXXXXGG                  