            XXXXXXXX    XXXXXX
XXXXXXXX    XXXXH1XX    XXGGXX
XXXXS2XX    XXXXXXXX    XXXXXX
XXXXXXXX    XXXXXXXX    XXXXXX
XXIIXXXXD2D2XXXXXXXXD1D1XXXXXX
XXXXXXXX    XXXXXXXX