                      XXXXXXXX
  XXXXXXXXE1E1XXS1XXXXXXXXIIXX
  XXXXXXXX              XXXXXX
  XXXXS2XX                    
  XXXXXXXX                    
      XXXXXXS3XXE2E2XXXXXX
                    XXXXXXXXS4
XXXXXX              XXXXXXXXXX
XXGGXXXXXXS2S2XXXXXXXXXXXX
XXXXXXXX