                      XXXXXXXX
  XXXXXXXXA1A1XXt1XXXXXXXXIIXX
  XXXXXXXX              XXXXXX
  XXXXe2XX                    
  XXXXXXXX                    
      XXXXXXd2XXA3A3XXXXXX
                    XXXXXXXXt2
XXXXXX              XXXXXXXXXX
XXGGXXXXXXA2A2XXXXXXXXXXXX
XXXXXXXX