                XXXXXXXX
                XXXXXXXX
XXXXXX          XX    XXXXXXXX
XXIIXXXXXXXXXXXXXX      XXGGXX
XXXXXX        XXXXH1    XXXXXX
XXXXXX        XXXXXX    XXXXXX
  XXXXD1      XX
    XXXXXXXXXXXX