XXXXXXIIXX
XXXXYYYYYY
XXXXYYXXE1
XXXXYYXXXX
      U1  
      U1  
XXXXXXXXXX
XXYYYYXXXX
XXYYXXE2XX
XXXXXXXXXX
    U2    
    U2    
XXYYXXXXE3
XXYYXXXXXX
XXYYXXXXXX
XXXXXXXXXX
    U3    
    U3    
XXXXXXXXXX
XXXXXXXXXX
XXXXGGXXXX
XXYYYYXXXX
