XXXXXXIIXX
XXXXXXXXXX
XXYYYYYYE1
XXYYXXXXXX
XXYYXXXXXX
      U1  
      U1  
XXXXXXXXXX
XXXXYYXXXX
XXXXXXXXXX
XXXXXXE2XX
XXXXXXXXXX
      U2  
      U2  
XXXXXXXXXX
XXXXXXXXXX
XXYYXXXXXX
XXYYE3XXXX
XXYYXXXXXX
        U3
        U3
XXXXXXXXXX
XXXXXXXXXX
XXXXXXXXXX
E4XXXXXXXX
YYXXXXXXXX
    U4    
    U4    
XXXXXXXXXX
XXXXXXXXXX
XXXXXXXXXX
XXXXXXXXXX
XXXXGGXXXX
