XXXXXXXXXX
XXXXXXXXXX
XXXXE1YYYY
XXXXXXIIXX
  U1      
  U1      
XXE2YYYYYY
XXXXXXYYXX
XXXXXXXXXX
XXXXXXXXXX
  U2      
  U2      
XXXXGGXXXX
XXXXXXXXXX
XXXXXXXXYY
XXXXXXXXXX
