XXXXXXXXII
XXXXXXXXXX
XXXXXXE1XX
XXXXXXXXXX
YYYYYYYYXX
        U1
        U1
XXXXXXE2XX
XXYYYYYYYY
XXYYYYXXXX
XXXXYYXXXX
XXXXXXXXXX
        U2
        U2
XXYYYYE3XX
XXXXXXYYXX
XXXXXXYYXX
XXXXXXXXXX
XXXXXXXXXX
    U3    
    U3    
XXXXXXXXXX
XXXXXXXXXX
XXXXYYXXXX
XXE4XXXXXX
XXXXXXXXXX
        U4
        U4
XXXXXXXXXX
YYYYXXXXXX
XXYYXXXXXX
XXYYYYYYYY
XXXXXXXXE5
    U5    
    U5    
XXXXXXXXXX
XXXXE6XXXX
XXXXXXXXXX
XXXXXXXXXX
XXXXXXXXXX
      U6  
      U6  
XXXXXXXXXX
XXYYYYXXXX
YYYYYYXXXX
YYXXXXXXXX
YYXXGGXXXX
