XXXXE1XXXX
XXXXXXIIXX
XXYYXXXXXX
XXXXXXXXXX
      U1  
      U1  
XXXXXXXXXX
XXXXXXE2XX
XXXXXXXXXX
XXYYYYYYYY
U2        
U2        
XXXXXXXXXX
XXXXYYYYXX
XXE3YYYYYY
XXXXXXXXYY
U3        
U3        
XXXXXXXXXX
XXXXE4XXXX
XXXXXXXXXX
XXXXXXYYXX
U4        
U4        
XXYYXXXXXX
XXXXXXXXXX
XXXXXXXXXX
XXXXXXXXGG
