E1YYYYXXXX
XXXXYYXXXX
XXIIYYYYXX
XXXXXXYYXX
        U1
        U1
XXXXE2XXXX
XXXXXXXXXX
YYYYYYYYXX
XXXXXXXXXX
        U2
        U2
XXXXXXXXXX
XXXXXXXXXX
E3XXXXXXXX
XXXXXXXXXX
        U3
        U3
XXYYXXXXXX
XXE4XXXXXX
XXXXXXXXXX
XXXXXXXXXX
    U4    
    U4    
XXXXXXXXXX
XXXXE5XXXX
XXXXXXXXXX
XXXXXXXXXX
  U5      
  U5      
XXXXXXXXE6
XXXXXXXXXX
YYXXXXXXXX
XXXXXXXXXX
      U6  
      U6  
XXXXXXE7XX
YYXXXXXXXX
XXXXXXXXXX
XXXXXXXXXX
  U7      
  U7      
XXXXXXXXXX
XXXXXXXXXX
XXXXE8XXXX
XXXXXXXXXX
  U8      
  U8      
XXXXXXXXXX
XXXXXXXXXX
XXE9XXXXXX
XXXXXXXXXX
      U9  
      U9  
YYGGXXXXXX
XXYYXXXXXX
XXYYYYYYXX
XXXXXXYYXX
