IIXXXXXXXX
XXXXXXXXXX
XXXXXXXXXX
XXYYYYXXXX
XXGGXXXXXX
