XXXXXXXXXX
XXXXXXXXXX
XXXXXXXXXX
XXE1YYXXXX
IIXXYYXXXX
      U1  
      U1  
XXXXE2XXXX
XXXXXXXXXX
XXXXXXXXXX
YYXXXXXXXX
XXXXXXXXXX
    U2    
    U2    
XXXXXXXXXX
XXXXYYYYE3
XXXXXXXXYY
XXXXXXXXYY
XXXXXXXXYY
    U3    
    U3    
XXXXXXXXXX
XXXXYYYYYY
XXXXYYXXXX
XXXXYYXXXX
E4XXXXXXXX
        U4
        U4
XXXXXXXXXX
XXXXXXXXXX
XXXXXXXXE5
XXXXXXYYXX
XXXXXXXXXX
        U5
        U5
XXXXYYYYXX
XXXXXXYYXX
XXXXXXYYXX
E6XXXXYYYY
XXXXXXXXXX
    U6    
    U6    
XXXXXXXXXX
XXXXXXXXXX
XXXXXXYYXX
E7XXXXXXXX
XXXXXXXXXX
    U7    
    U7    
XXXXXXXXXX
XXXXXXXXGG
XXXXXXXXXX
XXXXXXXXXX
XXXXXXXXXX
