XXXXXXXXXX
XXXXXXYYYY
XXXXXXIIXX
XXXXXXYYXX
XXXXE1YYXX
    U1    
    U1    
XXXXXXXXXX
XXXXXXYYXX
XXXXYYYYXX
XXXXYYXXXX
XXXXE2XXXX
        U2
        U2
XXXXXXXXXX
XXXXXXXXXX
XXXXYYYYXX
XXE3XXYYXX
XXXXXXXXXX
        U3
        U3
XXXXXXXXXX
XXYYXXXXXX
XXXXXXXXXX
XXXXXXGGXX
XXXXXXXXXX
