XXXXIIXXXX
XXXXXXXXE1
XXXXXXYYXX
XXXXXXXXXX
        U1
        U1
XXXXXXXXXX
XXXXE2XXXX
XXXXXXXXXX
XXXXYYYYXX
  U2      
  U2      
XXXXXXXXXX
XXYYYYYYYY
XXYYYYXXXX
XXXXYYXXE3
U3        
U3        
XXXXXXXXXX
XXXXXXXXXX
E4XXXXXXXX
YYXXXXXXXX
    U4    
    U4    
XXXXE5YYXX
XXXXYYYYYY
XXXXXXXXYY
XXXXXXXXYY
    U5    
    U5    
XXXXXXXXXX
XXXXXXE6XX
XXXXXXXXXX
XXXXYYXXXX
U6        
U6        
XXXXXXXXXX
E7XXYYXXXX
XXXXYYXXXX
XXXXXXXXXX
U7        
U7        
XXYYYYYYXX
XXYYXXXXXX
XXXXXXXXXX
XXE8XXXXXX
        U8
        U8
YYYYYYXXXX
GGXXXXXXXX
XXXXXXXXXX
XXXXXXXXXX
