XXXXYYYYXX
XXXXXXYYXX
IIYYYYYYXX
XXYYXXXXXX
XXYYE1XXXX
        U1
        U1
XXXXXXXXXX
XXXXXXXXXX
XXXXYYXXXX
XXE2XXXXXX
XXXXXXXXXX
        U2
        U2
XXXXXXXXXX
XXGGXXXXYY
XXXXXXXXYY
XXXXXXXXYY
XXXXXXXXYY
