XXXXXXXXXX
XXXXXXXXXX
YYYYYYXXE1
YYXXXXXXXX
XXXXIIXXXX
    U1    
    U1    
XXXXXXXXXX
XXXXXXE2XX
XXXXXXXXXX
XXXXXXXXXX
XXXXXXXXXX
U2        
U2        
E3YYYYYYXX
XXXXXXYYXX
XXXXXXYYXX
XXXXYYYYXX
XXXXYYXXXX
U3        
U3        
XXXXE4XXXX
XXXXXXXXXX
XXXXYYXXXX
XXXXXXXXXX
XXXXXXXXXX
U4        
U4        
XXXXXXXXXX
XXXXE5XXXX
XXYYXXXXXX
XXXXXXXXXX
XXXXXXXXXX
        U5
        U5
YYYYYYXXXX
YYXXXXXXXX
YYXXXXXXXX
E6XXXXXXXX
XXXXXXXXXX
  U6      
  U6      
XXXXXXXXXX
XXXXXXXXXX
E7XXXXXXXX
XXXXXXYYXX
XXXXXXXXXX
      U7  
      U7  
YYXXXXXXXX
XXXXXXXXXX
XXXXXXXXXX
XXXXXXXXXX
XXXXXXE8XX
      U8  
      U8  
XXXXXXXXXX
XXXXXXXXXX
YYYYXXXXXX
E9YYXXXXXX
XXXXXXXXXX
    U9    
    U9    
XXXXXXXXXX
YYYYYYYYXX
YYXXXXXXXX
GGXXXXXXXX
YYYYYYYYXX
