XXIIXXXXXX
XXXXYYYYXX
XXXXYYXXXX
XXXXYYXXXX
XXXXXXXXGG
