XXYYYYYYYY
XXXXXXXXYY
E1XXXXXXYY
XXXXIIXXXX
U1        
U1        
XXXXXXXXXX
XXXXXXXXE2
YYYYYYXXXX
YYXXXXXXXX
  U2      
  U2      
XXXXYYYYYY
XXXXYYXXE3
XXXXYYXXXX
XXXXXXXXXX
    U3    
    U3    
XXXXXXXXXX
YYYYXXXXE4
XXYYXXXXXX
XXXXXXXXXX
        U4
        U4
YYYYYYXXXX
YYYYYYXXXX
XXXXXXXXXX
XXXXE5XXXX
      U5  
      U5  
XXXXXXXXXX
XXYYYYYYXX
XXXXYYXXXX
GGXXXXXXXX
