XXXXE1XX
XXXXXXXX
XXXXXXII
      U1
      U1
XXXXE2XX
XXXXXXXX
XXXXXXXX
  U2    
  U2    
XXXXXXXX
XXXXXXXX
E3XXXXXX
  U3    
  U3    
E4XXXXXX
XXYYYYXX
XXXXYYXX
  U4    
  U4    
XXXXXXXX
XXXXXXYY
XXXXXXE5
    U5  
    U5  
XXXXXXXX
YYGGXXXX
YYYYYYXX
