XXXXXXXXXX
XXYYYYYYII
XXYYXXXXXX
XXXXXXE1XX
        U1
        U1
XXXXXXYYXX
XXXXXXYYXX
XXXXE2XXXX
XXXXXXXXXX
        U2
        U2
XXE3XXXXXX
XXXXXXXXXX
XXXXXXXXXX
XXXXXXXXXX
U3        
U3        
XXYYYYXXXX
XXYYXXXXE4
XXYYXXXXXX
XXXXXXXXXX
    U4    
    U4    
XXXXXXXXXX
YYYYYYXXXX
XXXXE5XXXX
XXXXYYYYYY
U5        
U5        
XXYYYYYYXX
XXYYXXXXXX
XXYYYYYYYY
E6XXXXXXYY
  U6      
  U6      
XXXXXXXXXX
XXXXYYXXXX
XXXXXXXXXX
XXXXE7XXXX
  U7      
  U7      
XXXXXXXXXX
XXXXE8XXXX
XXXXXXXXXX
XXXXXXXXXX
        U8
        U8
XXXXXXXXXX
GGXXYYYYYY
XXXXXXXXYY
XXXXXXXXXX
