XXXXXXXXXX
XXYYE1YYXX
XXXXXXYYII
XXXXXXYYXX
  U1      
  U1      
XXE2XXXXXX
XXXXXXYYYY
XXXXYYYYYY
XXXXYYYYYY
U2        
U2        
XXXXXXXXXX
XXXXXXXXXX
YYXXXXE3XX
XXXXXXXXXX
        U3
        U3
XXXXXXXXXX
XXXXXXXXXX
XXE4XXXXXX
XXXXXXXXXX
    U4    
    U4    
XXXXXXXXXX
YYE5YYXXXX
XXYYXXXXXX
XXYYXXXXXX
        U5
        U5
XXYYXXXXXX
XXYYXXXXXX
XXXXXXXXE6
XXXXXXXXXX
      U6  
      U6  
YYXXXXXXXX
YYXXXXXXXX
YYXXE7XXXX
XXXXXXXXXX
  U7      
  U7      
XXXXXXXXXX
XXYYYYYYYY
YYYYXXXXXX
YYXXXXE8XX
  U8      
  U8      
XXXXXXXXXX
YYYYXXXXE9
XXYYYYYYYY
XXXXXXXXXX
        U9
        U9
YYYYYYXXXX
YYXXXXXXXX
YYYYXXXXXX
XXXXGGXXXX
