XXXXE1XX
XXXXYYXX
XXIIXXXX
    U1  
    U1  
XXXXXXXX
XXXXYYXX
XXXXYYE2
      U2
      U2
XXXXXXXX
XXXXXXE3
YYXXXXXX
  U3    
  U3    
XXXXXXXX
XXXXXXXX
E4XXXXXX
    U4  
    U4  
XXXXXXXX
XXYYXXXX
XXGGXXXX
