XXE1XXXXXX
XXXXYYYYYY
XXXXYYIIXX
XXXXYYXXXX
      U1  
      U1  
YYYYXXE2XX
XXYYYYYYXX
XXYYXXXXXX
XXXXXXXXXX
      U2  
      U2  
XXXXXXXXXX
XXXXXXXXXX
XXXXYYXXXX
E3XXXXXXXX
U3        
U3        
XXYYYYYYYY
XXXXXXXXYY
XXXXXXE4YY
XXXXXXXXXX
        U4
        U4
YYYYXXXXXX
YYYYYYYYXX
XXE5XXYYXX
XXXXXXYYXX
U5        
U5        
XXXXXXXXXX
YYE6YYYYXX
XXXXXXYYXX
XXXXXXYYXX
  U6      
  U6      
XXXXXXXXXX
XXXXXXXXXX
XXXXGGXXXX
XXXXXXXXXX
