XXXXXXXXXX
XXYYXXXXXX
XXYYYYYYXX
XXYYIIYYYY
E1XXXXXXYY
  U1      
  U1      
XXXXXXXXXX
XXXXXXGGXX
XXXXXXYYYY
XXXXYYYYYY
XXXXYYXXXX
