XXXXYYXX
XXE1XXXX
XXXXIIXX
  U1    
  U1    
XXXXXXXX
XXXXE2XX
XXXXXXXX
    U2  
    U2  
XXXXXXXX
XXXXXXXX
XXE3XXXX
      U3
      U3
XXE4XXXX
XXXXXXXX
XXXXXXXX
  U4    
  U4    
XXXXXXXX
XXXXXXXX
E5XXXXXX
U5      
U5      
XXXXXXXX
E6XXXXXX
XXXXYYXX
  U6    
  U6    
XXXXXXXX
XXYYXXXX
XXGGXXXX
