E1XXXXXX
XXXXXXXX
XXXXIIXX
      U1
      U1
XXXXE2XX
XXXXXXXX
XXXXXXXX
U2      
U2      
XXXXXXXX
E3XXXXXX
XXXXXXXX
U3      
U3      
XXXXXXXX
XXE4XXXX
XXXXXXXX
  U4    
  U4    
XXE5XXXX
XXYYYYXX
XXXXYYXX
U5      
U5      
XXXXXXXX
XXXXXXE6
XXXXXXYY
U6      
U6      
XXE7XXXX
XXYYXXXX
XXXXXXXX
      U7
      U7
XXYYXXXX
XXXXXXXX
GGXXXXXX
