XXXXXXXXXX
XXXXXXXXXX
XXXXXXXXXX
XXXXXXE1XX
XXXXXXXXII
  U1      
  U1      
XXXXXXXXXX
XXYYXXXXXX
XXYYXXXXE2
XXYYYYYYYY
XXXXXXXXYY
      U2  
      U2  
YYYYYYE3XX
XXXXXXYYXX
XXXXXXYYXX
XXXXXXXXXX
XXXXXXXXXX
      U3  
      U3  
XXXXYYXXXX
E4XXXXXXXX
XXXXXXXXXX
XXXXXXXXXX
XXXXXXXXXX
  U4      
  U4      
XXXXXXXXXX
XXXXYYXXXX
XXYYYYE5XX
XXYYXXXXXX
XXXXXXXXXX
        U5
        U5
XXXXXXXXXX
XXXXXXXXXX
XXXXXXXXXX
GGXXXXXXXX
XXXXXXXXXX
