XXXXE1XXXX
XXXXXXXXXX
XXXXXXXXII
XXXXXXXXYY
U1        
U1        
XXXXXXXXXX
XXXXYYYYXX
XXXXXXYYE2
XXXXXXYYXX
  U2      
  U2      
XXXXXXXXXX
XXXXXXE3XX
XXXXXXYYXX
XXXXXXXXXX
  U3      
  U3      
XXXXYYYYXX
YYYYYYYYXX
YYYYYYXXXX
E4XXXXXXXX
U4        
U4        
XXYYXXXXXX
XXYYE5XXXX
XXYYYYYYXX
XXXXXXXXXX
U5        
U5        
XXYYYYXXXX
XXE6YYXXXX
XXXXYYYYYY
XXXXXXXXXX
U6        
U6        
XXXXXXXXXX
XXXXXXXXYY
XXXXXXXXXX
XXE7XXXXXX
      U7  
      U7  
XXXXXXXXXX
YYYYYYYYXX
YYGGXXXXXX
XXXXXXXXXX
