IIXXXXYYXX
XXE1YYYYXX
XXXXYYXXXX
XXXXXXXXXX
        U1
        U1
YYXXXXXXXX
XXXXXXXXXX
XXGGXXXXXX
XXXXXXXXXX
