XXXXXXXXXX
XXXXYYYYYY
XXE1YYYYXX
XXXXXXYYXX
XXXXXXIIXX
      U1  
      U1  
XXXXXXXXXX
XXXXYYYYYY
XXXXYYXXXX
E2XXYYXXXX
XXXXXXXXXX
    U2    
    U2    
XXXXXXXXXX
XXXXXXXXXX
XXXXE3XXXX
XXXXXXYYYY
XXXXXXXXYY
  U3      
  U3      
XXXXXXXXXX
XXXXXXXXXX
XXXXXXXXYY
E4XXXXXXXX
XXXXXXXXXX
      U4  
      U4  
XXXXXXXXXX
XXYYYYYYYY
XXYYXXXXXX
XXYYXXXXE5
XXYYXXXXXX
        U5
        U5
XXXXXXXXXX
XXXXYYE6YY
XXXXXXXXYY
XXXXXXXXXX
XXXXXXXXXX
    U6    
    U6    
XXXXXXXXXX
XXXXE7XXXX
XXXXYYYYYY
XXXXXXYYYY
XXXXXXYYXX
    U7    
    U7    
XXXXXXXXXX
XXXXXXXXXX
XXXXXXXXXX
YYYYYYYYXX
XXXXE8XXXX
      U8  
      U8  
XXXXXXXXXX
XXYYYYYYXX
XXYYXXXXXX
XXXXXXXXXX
XXE9XXXXXX
        U9
        U9
XXXXXXXXXX
XXXXXXXXXX
XXXXXXXXXX
XXXXXXE10XX
XXXXXXXXXX
      U10  
      U10  
XXXXXXXXXX
XXXXXXXXXX
XXXXXXXXXX
XXXXXXXXXX
XXXXGGXXYY
