XXXXXXXXXX
XXYYYYXXXX
E1XXYYXXXX
XXXXYYXXXX
XXIIYYXXXX
      U1  
      U1  
XXXXXXE2XX
XXXXXXXXXX
XXXXXXXXXX
XXXXXXXXXX
XXXXYYXXXX
      U2  
      U2  
XXXXXXXXXX
XXXXXXXXXX
XXXXXXXXXX
XXXXXXXXXX
XXXXXXYYE3
U3        
U3        
XXXXYYYYXX
YYE4YYYYXX
YYXXXXXXXX
YYXXXXXXXX
YYXXXXXXXX
  U4      
  U4      
XXXXXXXXXX
XXXXXXXXXX
XXXXXXXXXX
E5XXXXXXXX
XXXXXXXXXX
    U5    
    U5    
XXXXXXXXXX
XXE6XXXXXX
XXXXXXYYYY
XXXXXXYYXX
XXXXXXYYXX
U6        
U6        
XXXXXXXXXX
XXXXXXXXXX
XXYYYYYYYY
XXYYXXXXE7
XXXXXXXXXX
      U7  
      U7  
XXXXXXXXXX
XXXXXXXXXX
XXXXXXXXXX
XXXXXXXXE8
XXXXXXXXXX
    U8    
    U8    
XXXXXXXXGG
XXXXXXXXXX
XXXXXXXXXX
XXXXXXXXXX
XXXXXXXXXX
