XXXXXXXX
XXXXXXE1
XXIIXXYY
  U1    
  U1    
XXXXXXE2
XXYYYYYY
XXXXXXXX
  U2    
  U2    
XXXXXXE3
YYYYXXXX
XXXXXXXX
      U3
      U3
XXXXXXE4
XXYYYYYY
XXYYXXXX
      U4
      U4
YYYYXXXX
XXYYYYXX
XXXXXXGG
