            XXXXXXXXXXXXXX
XXXXXXXX    XXXXXX    XXXX
XXXXXXXXXXXXXXXXXX    XXXXXXXX
XXIIXXXX              XXXXGGXX
XXXXXXXX              XXXXXXXX
                        XXXXXX