                XXXXXXXX
                XXXXXXXX
XXXXXX          XX    XXXXXXXX
XXIIXXXXXXXXXXXXXX      XXGGXX
XXXXXX        XXXXT1    XXXXXX
XXXXXX        XXXXXX    XXXXXX
  XXXXU1      XX
    XXXXXXXXXXXX