            XXXXXXXX    XXXXXX
XXXXXXXX    XXXXT2XX    XXGGXX
XXXXt1XX    XXXXXXXX    XXXXXX
XXXXXXXX    XXXXXXXX    XXXXXX
XXIIXXXXU1U1XXXXXXXXU2U2XXXXXX
XXXXXXXX    XXXXXXXX