XXXXXX
XXIIXXXXXXXX
XXXXXXXXXXXXXXXXXX
  XXXXXXXXXXXXXXXXXX
          XXXXGGXXXX
            XXXXXX