XXXXXXXX
XXXXXXXX
XXXXXXXX
XXXXXXXX
  U1    
  U1    
XXXXXXXX
XXd2XXXX
XXXXE1XX
IIXXXXXX
    A2  
    A2  
XXGGXXXX
XXXXXXXX
XXXXXXXX
XXXXXXXX