XXd2XXXX
XXXXe1XX
IIXXXXXX
XXXXXXXX
  U1    
  U1    
XXXXXXXX
XXXXXXXX
XXXXXXXX
XXXXXXXX
      A2
      A2
XXGGXXXX
XXXXXXXX
XXXXXXXX
XXXXXXXX