XXXXXXXX
XXd2XXXX
XXXXXXXX
XXXXXXXX
      U1
      U1
XXXXXXXX
XXXXe1XX
XXXXXXXX
XXXXXXII
      A2
      A2
XXXXXXXX
XXXXGGXX
XXXXXXXX
XXXXXXXX