XXXXXXXX            
XXIIXXe1            
XXXXXXXX            
XXXXXXXX            
      U1            
      U1            
XXXXXXe2    XXXXXXE3
XXXXXXXXU2U2XXd6XXXX
XXXXd5XX    XXXXXXXX
XXXXXXXX    XXXXXXXX
  U3                
  U3                
XXXXD7XX            
XXXXXXXX            
XXXXXXE4            
XXXXXXXX            
      U4            
      U4            
XXXXXXXX            
XXXXXXXX            
XXXXXXXX            
XXXXXXXX            
      A5            
      A5            
XXXXXXXX            
XXXXXXXX            
XXXXXXXX            
XXXXXXXX            
      A6            
      A6            
XXXXXXXX            
XXXXXXXX            
XXXXXXXX            
XXGGXXXX            
      A7            
      A7            
XXXXXXXX            
XXXXXXXX            
XXXXXXXX            
XXXXXXXX            