XXXXXXXX
XXe1XXXX
XXXXXXXX
IIXXXXXX
    U1  
    U1  
XXXXXXXX
XXXXXXXX
XXXXXXXX
d2XXXXXX
  A2    
  A2    
XXXXXXGG
XXXXXXXX
XXXXXXXX
XXXXXXXX