XXXXXXXX
XXXXD2XX
XXXXXXXX
XXXXXXXX
    U1  
    U1  
XXXXXXXX
XXXXXXXX
E1XXXXXX
XXIIXXXX
      A2
      A2
XXXXXXXX
XXXXXXGG
XXXXXXXX
XXXXXXXX