XXXXXXXX
XXXXXXXX
XXXXXXXX
XXXXGGXX
      U1
      U1
XXXXE1XX
XXXXXXXX
XXXXXXII
XXXXXXXX