XXIIXXXX
XXXXXXXX
XXXXXXE1
XXXXXXXX
U1      
U1      
XXXXXXXX
XXXXXXXX
XXXXXXe2
XXXXXXXX
  U2    
  U2    
XXXXXXXX
XXXXXXGG
XXXXXXXX
XXXXXXXX