XXXXXXGG
XXXXXXXX
XXXXXXXX
XXXXXXXX
      U1
      U1
XXIIXXXX
XXXXXXXX
XXXXXXe1
XXXXXXXX