E1XXXXXX
XXXXIIXX
XXd2XXXX
XXXXXXXX
U1      
U1      
XXXXXXXX
XXXXXXXX
XXXXXXXX
XXXXXXXX
    A2  
    A2  
XXXXXXXX
XXXXXXXX
XXXXXXXX
XXXXXXGG