XXXXXXXX
XXXXXXXX
XXXXXXD2
XXXXXXXX
U1      
U1      
XXE1XXXX
XXXXXXXX
IIXXXXXX
XXXXXXXX
  A2    
  A2    
XXXXXXXX
XXXXXXGG
XXXXXXXX
XXXXXXXX