XXXXXXXX
XXXXXXD2
XXXXXXXX
XXXXXXXX
      U1
      U1
XXXXXXXX
XXe1XXXX
XXXXXXXX
IIXXXXXX
A2      
A2      
XXXXXXXX
XXGGXXXX
XXXXXXXX
XXXXXXXX