XXe1XXXX
XXXXD2XX
XXXXXXII
XXXXXXXX
U1      
U1      
XXXXXXXX
XXXXXXXX
XXXXXXXX
XXXXXXXX
      A2
      A2
XXXXXXXX
XXXXXXXX
XXXXXXXX
XXXXGGXX