XXXXXXXX    XXXXXXXX    XXD6XXXX
XXIIXXXX    XXXXE2XX    XXXXXXXX
XXXXE1XXU1U1XXXXXXd5U2U2XXXXE3XX
XXXXXXd7    XXXXXXXX    XXXXXXXX
  U3                            
  U3                            
XXXXe4XX                        
XXXXXXXX                        
XXXXXXXX                        
XXXXXXXX                        
      U4                        
      U4                        
XXXXXXXX                        
XXXXXXXX                        
XXXXXXXX                        
XXXXXXd8                        
A5                              
A5                              
XXXXXXXX                        
XXXXXXXX                        
XXXXGGXX                        
XXXXXXXX                        
    A6                          
    A6                          
XXXXXXXX                        
XXXXXXXX                        
XXXXXXXX                        
XXXXXXXX                        
A7                              
A7                              
XXXXXXXX                        
XXXXXXXX                        
XXXXXXXX                        
XXXXXXXX                        
A8                              
A8                              
XXXXXXXX                        
XXXXXXXX                        
XXXXXXXX                        
XXXXXXXX                        