XXXXXXXX
XXXXE1XX
XXXXXXXX
IIXXXXXX
    U1  
    U1  
XXXXXXXX
XXXXXXXX
XXE2XXXX
XXXXXXXX
  U2    
  U2    
XXXXXXXX
XXXXXXXX
XXXXXXXX
XXXXXXGG